16 16
3
5
6
3 10
0;0;0;0;0;0;0;0;0;0;0;0;0;0;0;0
0;0;0;0;0;2;2;2;2;2;2;2;2;2;2;0
0;0;0;1;1;1;2;2;2;2;2;2;2;2;2;0
0;1;1;1;1;1;1;1;1;1;2;2;2;2;2;0
0;1;1;1;1;1M;5;5;5;5;5;5;5P;5;5;0
0;1;1;1;1;1;5;5M;5;5;5;5;5;5;5;0
0;1;1;1;1;1;1;1;1;3M;3;3;3;3;5;0
0;1;1;1;1;1;1;3;3;3;3;3;3;3;3;0
0;4;4;4;4;4;4;3;3;3M;3;3P;3;3;3;0
0;4;4;4;4;4;3;3;3;3;3;3;3;3;3;0
0;4;4;4;4;3;3;3;3;3M;3;3;3;3;3;0
0;4;4;4;4;0;0;0;0;0;0;0;3;3;3;0
0;4;4;4P;0;0;0;0;0;0;0;0;3;3;3;0
0;4;4;0;0;0;0;0;0;0;0;0;0;3;3;0
0;0;0;0;0;0;0;0;0;0;0;0;0;3;3;0
0;0;0;0;0;0;0;0;0;0;0;0;0;0;0;0
